111111111111111111111111111111
110001000100010001000100010001
100101000100010001000100010001
110101010101010101010101010101
100101010101010101010101010101
110101010101010101010101010101
100101010101010101010101010101
110101010101010101010101010101
100100010101010101010101010101
101000010101010101010101010101
110010010101010101010101010101
100100100101010101010101010101
101001001001010101010101010101
110010010010010101010101010101
100100100100100101010101010101
110101001001001001010101010101
100101010010010010010101010101
110101010100100100100101010101
100101010101001001001001010101
110101010101010010010010010101
100101010101010100100100110101
110101010101010101001001000101
100101010101010101010010010101
110101010101010101010100100101
100101010101010101010101010101
110101010101010101010101010101
100101010101010101010101010101
110100010001000100010001011101
100100010001000100010001000001
111111111111111111111111111101
